61 61 59 61 61 61 61 59 61 61 61 61 59 61 61 61 61 59 61 61 61 61 59 61 61 61 61 59 61 61 61 59 61 61 59 61 61 61 61 59 61 61 61 61 61 59 61 61 61 61 61 59 61 61 61 61 61 59 61 61 61 61 61 59 61 61 61 61 59 61 61 61 61 59 61 61 61 61 61 59 61 61 61 61 61 61 61 61 59 61 61 61 61 61 59 61 61 61 61 61 59 61 61 61 61 61 59 61 61 61 61 61 59 61 61 61 61 59 61 61
61 17 17 17 17 18 19 17 18 19 61 18 19 17 18 19 17 18 19 58 18 19 17 18 19 17 57 19 17 18 19 17 17 17 18 19 61 61 61 61 17 18 19 17 18 17 18 17 18 18 17 18 17 17 18 57 18 17 18 17 18 17 18 17 61 61 17 18 19 19 19 59 18 17 58 17 18 17 18 61 17 18 19 58 17 59 17 17 17 17 17 17 17 17 18 19 19 57 19 19 19 19 17 17 61 61 17 17 18 18 18 61 57 18 18 18 18 18 17 61
61 58 24 24 17 17 18 24 25 58 61 25 17 24 25 26 24 25 26 17 18 19 24 25 26 17 18 19 24 25 26 24 24 24 25 26 24 59 61 61 17 17 18 24 25 24 25 24 25 25 24 25 24 24 25 24 25 24 25 24 25 24 25 24 59 61 19 19 19 26 26 61 25 24 25 24 25 17 18 61 17 18 19 17 17 61 17 17 18 19 19 19 19 19 19 19 26 26 26 26 26 26 19 19 59 59 18 18 18 18 18 60 25 25 25 25 18 18 18 61
59 17 18 19 19 17 17 57 19 24 61 26 24 25 59 26 59 25 26 24 25 26 24 61 59 61 61 26 24 17 18 19 24 25 17 18 24 61 61 61 24 17 59 61 61 61 59 19 26 26 26 26 19 17 18 17 18 19 19 19 24 17 18 17 61 57 58 26 26 25 26 60 26 26 19 19 19 58 25 61 17 18 19 17 17 61 19 19 19 58 26 26 26 26 26 26 24 24 24 24 25 26 18 18 61 61 18 18 18 18 18 61 25 25 18 58 18 25 18 61
61 18 19 19 26 19 19 18 19 17 61 19 19 19 61 19 61 19 18 17 18 19 19 61 61 61 59 19 19 59 25 26 17 18 24 58 17 18 59 61 17 18 61 61 61 61 61 19 17 18 24 58 26 24 25 17 18 19 61 61 61 24 25 24 24 25 17 17 18 19 19 59 57 26 26 26 26 26 19 61 61 61 61 60 61 59 17 17 18 17 17 17 17 25 26 26 26 26 26 19 19 19 25 25 57 25 25 25 25 25 25 61 61 59 61 25 18 25 18 59
61 17 18 19 25 26 26 17 18 19 61 26 26 26 61 59 61 26 19 24 25 26 19 61 61 61 61 26 26 61 17 18 24 25 24 25 17 18 57 59 17 18 61 61 17 17 18 19 24 17 18 25 26 26 19 18 19 19 59 61 61 58 19 17 18 19 19 17 17 17 18 61 61 61 59 61 61 59 61 59 17 18 19 17 24 24 24 24 17 17 17 17 18 19 18 19 61 24 25 26 26 26 19 25 25 25 25 25 25 25 25 25 26 25 61 61 59 61 61 61
61 61 61 61 61 60 61 61 61 61 61 17 18 19 19 57 25 26 19 24 25 26 26 59 61 61 61 26 25 61 61 61 26 19 26 26 17 18 19 61 17 18 61 61 24 59 61 61 19 17 18 24 25 26 26 19 19 26 61 61 59 19 26 19 19 19 26 24 24 17 17 18 19 17 18 19 24 25 26 61 17 18 19 24 24 24 24 24 24 24 24 24 17 57 19 17 61 19 19 19 24 58 26 26 26 26 19 19 19 19 19 19 19 25 25 18 25 25 18 61
61 17 18 19 17 18 24 17 17 17 17 18 19 19 26 24 25 26 26 26 24 25 26 61 61 61 59 26 25 61 61 61 19 58 24 25 17 18 19 61 17 17 59 61 18 61 61 61 17 24 25 17 18 24 25 26 26 19 61 61 61 26 19 26 26 19 19 19 19 19 17 17 17 17 17 58 24 25 26 61 17 18 19 26 17 18 24 25 17 18 19 26 24 17 18 19 59 61 26 26 26 25 17 24 25 26 26 26 26 26 26 58 26 26 25 25 25 18 18 61
59 17 18 17 18 17 24 24 24 17 18 19 19 26 25 26 17 58 59 61 59 17 17 24 58 26 26 24 25 59 61 59 19 26 17 24 24 57 26 61 17 17 18 25 25 61 61 59 19 19 19 24 25 19 24 58 26 26 19 24 25 26 26 24 25 26 61 59 61 26 19 17 24 24 17 24 24 25 57 61 17 18 19 61 61 19 19 17 17 17 18 17 18 17 18 19 57 61 61 26 17 17 18 17 18 19 17 18 19 19 24 25 26 25 26 25 18 18 25 59
60 17 17 18 19 24 17 59 61 61 61 59 26 26 17 17 24 24 61 61 61 24 24 25 24 25 26 19 25 17 18 19 26 17 17 24 25 26 26 59 17 17 18 24 58 17 18 19 26 26 26 26 26 19 17 24 25 26 26 17 24 25 26 17 24 25 59 61 59 58 26 17 24 25 24 24 24 25 26 59 17 18 19 59 61 58 17 18 24 17 18 17 18 17 18 19 24 24 24 17 24 17 18 17 18 19 17 18 19 26 24 25 26 24 25 25 18 25 18 60
59 17 17 18 17 17 17 17 57 17 58 61 26 17 24 24 24 25 61 61 61 25 26 25 26 24 25 26 19 18 19 19 18 17 18 19 24 25 26 60 17 17 17 18 25 17 18 19 24 17 24 25 26 57 61 59 61 24 25 24 24 25 26 24 24 24 61 59 61 24 17 24 24 25 26 24 24 25 26 60 17 18 19 17 17 17 17 17 17 24 17 17 17 18 19 19 24 25 17 58 24 17 18 17 18 19 17 17 17 17 24 25 26 24 25 25 25 25 25 59
61 17 17 17 24 17 24 24 24 17 18 59 24 24 25 26 17 24 59 61 59 26 24 24 25 24 58 26 26 19 19 26 17 17 18 19 24 25 26 59 17 24 17 18 25 57 17 17 17 17 17 18 19 25 59 61 59 17 18 24 25 26 17 24 25 24 25 18 26 24 24 24 25 26 25 24 24 25 26 59 17 18 19 24 17 24 24 24 61 59 61 61 61 61 61 59 61 61 61 61 61 59 61 61 61 61 24 24 24 24 58 61 59 61 26 25 25 25 18 61
61 17 17 24 25 24 18 18 18 18 17 17 18 17 18 19 19 25 26 26 17 17 59 61 26 17 24 25 26 26 26 59 61 61 61 59 24 25 26 61 17 24 17 17 18 17 24 24 24 24 24 17 17 17 61 59 61 24 25 24 17 17 24 25 26 19 24 25 26 17 24 25 26 24 25 58 26 26 19 61 17 17 17 17 24 24 17 18 61 57 19 19 19 26 26 17 17 17 17 24 24 24 24 24 17 61 18 19 24 25 17 61 59 61 26 25 25 25 25 61
59 61 61 61 61 59 61 61 61 59 61 17 17 18 19 19 26 17 17 17 24 24 61 59 24 17 24 24 25 26 24 61 61 61 61 61 24 25 26 61 17 18 18 17 18 17 17 24 25 17 17 18 19 58 24 17 18 19 17 17 17 18 19 24 17 17 24 25 59 61 61 61 59 61 61 61 61 59 61 61 24 24 24 17 18 19 19 19 61 26 26 26 26 24 24 58 24 17 17 17 18 19 19 19 24 59 17 17 17 17 57 61 59 61 18 25 25 58 18 61
61 24 24 25 26 25 57 24 24 24 61 17 18 19 19 26 24 24 24 24 25 26 24 25 26 24 24 25 26 17 58 61 61 58 17 17 24 25 26 61 24 25 25 17 59 61 24 17 18 17 17 17 17 18 19 19 19 59 61 61 59 61 61 59 18 19 24 25 61 57 24 25 26 24 25 26 24 25 58 61 17 17 18 59 17 17 18 19 61 17 18 19 19 19 61 61 59 61 61 19 19 26 58 26 19 61 19 19 19 18 18 25 25 18 25 25 25 17 18 61
61 17 18 58 24 25 24 17 18 19 61 17 18 19 19 59 61 61 57 25 26 17 17 57 59 17 17 17 17 24 17 61 61 25 24 17 24 25 26 61 17 18 58 18 61 61 24 17 18 17 59 61 17 17 17 18 19 26 57 25 61 58 24 17 18 19 24 24 61 17 24 25 26 24 25 26 24 25 26 59 17 18 57 61 24 17 17 17 59 24 25 26 26 26 59 61 61 61 59 26 26 26 26 26 61 61 26 26 26 25 25 25 18 18 17 25 25 17 18 59
61 17 18 17 24 25 61 61 60 59 61 17 18 19 19 24 61 61 26 24 24 24 24 24 61 24 24 17 17 17 24 59 61 17 17 17 24 25 58 59 17 18 25 25 61 59 17 17 18 17 61 61 24 24 17 18 19 19 24 25 61 26 26 17 17 17 58 17 59 61 61 60 61 59 25 26 24 25 26 61 17 17 17 61 18 17 17 17 61 17 17 17 17 17 61 61 59 61 61 57 17 17 24 24 61 57 18 18 18 25 25 25 25 25 18 25 25 17 18 61
59 17 17 17 24 25 61 17 24 24 24 17 17 17 17 17 61 59 17 17 17 17 17 17 61 24 25 24 24 24 24 61 61 17 24 24 24 25 26 61 17 17 17 17 17 17 24 17 18 17 17 59 24 24 17 18 17 17 24 25 61 25 26 24 24 24 17 24 17 24 25 26 17 61 58 17 24 25 26 61 17 18 18 59 58 24 24 59 61 24 24 24 24 24 24 24 24 24 24 24 24 24 24 25 60 25 25 25 25 25 25 58 25 25 25 25 59 61 61 61
61 24 24 24 24 25 61 24 25 26 26 24 24 24 24 24 24 24 24 24 24 58 24 24 61 25 26 24 57 26 26 61 61 24 24 25 24 25 26 61 24 24 24 24 24 24 24 24 58 24 24 61 57 26 24 25 24 58 24 25 61 24 57 24 24 25 24 24 24 24 25 26 24 61 24 24 24 25 57 61 57 17 17 61 17 17 17 61 59 58 17 17 17 17 17 17 17 17 17 17 17 17 17 17 61 17 17 17 17 17 17 17 17 17 17 17 57 61 61 61
61 61 61 61 59 61 61 61 61 61 59 61 61 61 61 59 61 61 61 61 59 61 61 61 61 59 61 61 61 61 59 61 61 61 61 61 59 61 61 61 61 61 61 59 61 61 61 61 61 59 61 61 61 61 61 59 61 61 61 61 61 59 61 61 61 61 61 59 61 61 61 61 61 59 61 61 61 61 61 59 61 61 61 59 61 61 61 61 61 59 61 61 61 61 61 59 61 61 61 61 59 61 61 61 59 61 61 61 61 59 61 61 61 61 59 61 61 61 61 59