9 9 9 60 9 9 9 60 9 9 9 60 9 9 9 60 9 9 9 60 9 9 9 60 9 9 9 60 9 9 9 60 9 9 9 60 9 9 9 60
60 16 59 23 16 17 18 23 23 9 23 23 23 16 16 16 17 9 58 23 16 17 16 23 16 17 9 19 16 17 18 16 17 18 19 26 17 18 19 9
9 23 23 24 16 17 18 23 24 60 26 17 18 23 23 16 16 17 18 23 16 17 23 24 16 17 9 19 16 17 18 16 17 59 19 26 18 19 26 9
9 23 24 25 16 17 58 17 24 9 26 19 9 9 24 23 16 16 16 23 16 16 23 24 16 17 9 58 17 18 19 16 17 18 19 26 19 19 25 9
60 17 18 19 19 58 9 60 9 9 25 26 60 9 24 58 23 23 23 24 9 9 60 25 16 17 18 16 17 18 19 60 17 18 60 26 19 59 25 60
9 60 57 60 9 9 9 19 59 17 18 19 19 26 16 17 23 24 23 24 60 9 9 16 17 18 19 16 17 18 19 9 17 18 9 26 26 24 25 9
9 18 19 26 26 19 18 19 23 17 18 19 19 26 19 17 18 23 24 25 23 58 25 16 17 18 19 16 17 18 19 9 58 18 9 26 23 24 25 9
60 17 18 19 17 18 19 17 18 19 25 26 26 25 26 18 19 23 24 16 23 24 16 16 17 18 16 17 18 59 16 9 9 60 9 23 24 25 26 9
57 17 18 17 18 19 16 16 23 17 9 26 24 25 26 19 19 25 26 59 23 24 23 23 16 9 16 17 18 19 16 17 18 19 16 23 24 25 59 60
9 17 16 16 17 9 59 16 17 59 60 23 24 58 9 60 9 25 26 17 24 25 23 24 16 9 16 17 18 19 16 17 18 19 16 23 24 25 26 9
9 17 23 23 16 9 23 16 17 9 9 18 23 24 60 9 60 24 16 23 24 16 23 24 16 60 58 16 16 16 16 9 60 9 16 23 24 25 26 57
9 16 23 24 23 23 16 17 18 23 16 17 18 16 9 60 9 24 16 23 24 23 24 25 16 9 23 16 17 18 23 9 9 9 58 23 24 25 26 9
60 9 9 9 60 9 9 9 18 23 16 17 16 23 16 17 18 23 23 24 25 23 9 25 16 9 16 17 18 19 23 24 25 26 23 24 25 26 19 60
9 18 19 58 19 19 16 9 18 23 16 17 23 24 16 17 18 23 23 24 25 58 9 25 16 17 16 16 59 18 19 19 19 19 23 16 17 18 19 9
9 18 19 19 19 26 16 60 58 17 16 17 23 24 16 17 18 17 59 25 26 23 60 9 16 17 23 16 16 16 16 59 18 19 23 23 60 9 9 9
60 17 18 17 18 19 9 9 9 9 16 17 23 24 9 17 16 23 24 25 26 23 9 9 16 17 18 23 23 23 23 16 17 18 23 24 25 26 19 9
9 18 19 26 59 17 16 17 18 9 16 16 23 24 60 58 23 24 23 24 25 23 9 9 9 9 9 23 23 24 25 16 60 9 9 60 25 26 26 60
9 18 19 24 25 26 19 19 58 9 16 23 24 25 9 9 9 9 9 24 16 23 60 9 9 60 9 19 16 16 16 16 9 9 9 9 19 19 59 9
9 17 58 19 24 25 26 26 26 60 16 23 24 25 26 59 23 24 23 24 23 24 25 59 16 17 18 19 16 17 18 19 60 9 9 60 26 26 26 9
60 16 16 16 16 16 16 17 18 57 17 23 24 25 26 23 24 25 23 24 23 24 25 17 23 16 17 18 23 24 25 26 58 16 16 16 17 18 16 9
9 59 23 23 23 16 59 16 16 60 17 23 24 25 26 23 24 9 59 24 23 24 25 16 16 16 16 16 16 9 16 23 23 23 23 16 16 16 23 60
9 9 9 60 9 9 9 60 9 9 9 60 9 9 9 60 9 9 9 60 9 9 9 60 9 9 9 60 9 9 9 60 9 9 9 60 9 9 9 60